11111111111
10000000001
10101010101
10000000001
10101010101
10000000001
10101010101
10000900001
11111111111
