1111111111111111111111111111111111111111111111111111111111111111111111111111111
1111111111111111111111111111111111000111111111111111111111111111111111111111111
1111111111111111111111111111111111000111111111111111111111111111111111111111111
1111111111111111111111111111111111000111111111111111111111111111111111111111111
1111111111111111111111111111111111000111111111111111111111111111111111111111111
1111111111111111111111111111111111000111111111111111111111111111111111111111111
1111111111111111111111111111111111000111111111111111111111111111111111111111111
1111111100000011111111111111111111000111111111111111111111111111111111111111111
1111111109000011111111111111111111000111111111111111111111111111111111111111111
1111111100000011111111111111111111000111111111111111111111111111111111111111111
1111111111100000000000000000000000000000000111111111111111111111111111111111111
1111111111100000000000000000000000000000000111111111111111111111111111111111111
1111111111100000000000000000000000000000000111111111111111111111111111111111111
1111111111100011111111111111111111111100000111111111111111111111111111111111111
1111111111100011111111111111111111111100000111111111111111111111111111111111111
1111111111100011111111111111111111111100000111111111111111111111111111111111111
1111111111100011111111111111111111111100000111111111111111111111111111111111111
1111111111100011111111111111111111111100000111111111111111111111111111111111111
1111111111100000000000011111111111111110001111111111111111111111111111111111111
1111111111100000000000011111111111111110001111111111111110000111111111111111111
1111111111100000000000011111111111111110001111111111111110000111111111111111111
1111111111100000000000011111111111111110001111111111111110000111111111111111111
1111111111100000000000011111111111111110001111111110001000110001000100011111111
1111111111100000000000011111111111111110001111111110001000110001000100011111111
1111111111100000000000011111111111111110001111111110001000110001000100011111111
1111111111111111111100000000000000000000000000000000000000000000000000001111111
1111111111111111111100000000000000000000000000000000000000000000000000001111111
1111111111111111111100000000000000000000000000000000000000000000000000001111111
1111111111111111111100000000000000000000000000000000000000000000000000001111111
1111111111111111111111111111111111111111111111111111111111111111111111111111111
