0110010101100101011001010110
0101011001010110010101100101
0110010101100101011001010110
0101011001010110010101100101
0110010100001101000010100110
0101001100000011000000110000
0011000000110000001100000011
0000001100000011000000110000
0011000000110000011001010111
0011011001000111001101100100
0111000101110011011001000000
1101000010100111001101100100
0111101001100100011110100110
0190011110100111101001100100
0111101000001101000010100111
0011011001000111000101110011
0111001101110011011100110110
0100011100010111001101100100
1111111111110111101001111010
