11111111111111111111111111111111111111111111
10000100001000010000100001111100000000110001
10000100001000010000100001111100000000110001
10000100001000010000100001111100000000110001
10000100001000010000100001111188111111110001
11811118111181111811118111111100000000000001
10000000000000000000000000000000000000000001
10000000000000000000000000000000000000000001
10000000000000000000000000000000000000000001
22222282222222222222222222222222222222222282
33333303333333333333333333333333333333333383
30000008000000000000000000000000000000000001
3000000412345678p123567812345678123456781241
30000004000000000000000000000000000000000001
30000008000000000000000000p00000000000000001
30000004321234567876543212345678765432123486
30000008000000000000000000000000000000000001
11111111111111111111111111111111111111111111
