11111111111111111111111111111111111111111111
11111111111111111000000000000000000000000001
11111111111111111000000000000000000000000001
11111111111111111000000000000000000000000001
11111111111111111000000000000000000000000001
11111111111111111000000000000000000000000001
11111111111111111000000000000000000000000001
11111111111111111000000000000000000000000001
11111111111111111000000000000009000000000001
11111111111111111000000000000000000000000001
11111111111111111000000000000000000000000001
11111111111111111000000000000000000000000001
11111111111111111000000000000000000000000001
11111111111111111000000000000000000000000001
11111100000000000000000000000000000000000001
11111100000000000000000000000000000000000001
11111100011111111111111111111111111000111111
11111100011111111111111111111111111100011111
11111100011111111111111111111111111100011111
11111100011111111111111111111111111100011111
10001100011111111111111111111111111100011111
10000000000000000000000000000000000000001111
10001000000000000000000000000000000000001111
11111100011111111111111111111111111100011111
11111100011111111111111111111111111100011111
11111100000000000000000000000000000000011111
11111100000000000000000000000000000000011111
11111100000000000000000000000000000000011111
11111100000000000000000000000000000000011111
11111111111111111111111111111111111111111111
11111111111111111111111111111111111111111111
11111111111111111111111111111111111111111111
