11111
10001
10901
10001
11111
