1111111111
1000000001
1000010001
1190000001
1000090001
1111111111
