11111111111111
10000000100001
10000000000001
10000010001001
10000000000001
10090000100001
10000000000001
11111111111111
