1111111
1000001
1809001
1000001
1111111
