11111111111
19000000001
10000000001
10000000001
10800000001
10000000001
11111111111
