11234567891
10000000001
10000000001
10000p00001
10000000001
11234567891
